25 25
1 1 1 1 1 6 1 1 1 1 5 5 5 5 5 10 7 12 1 1 6 1 1 1 6 
1 1 1 1 1 6 1 1 1 3 5 5 5 5 5 6 1 6 1 1 10 7 7 7 8 
11 7 7 11 7 9 11 7 7 17 5 5 5 5 5 6 1 10 7 7 12 1 1 1 6 
6 1 1 6 1 1 6 1 1 6 5 5 5 5 5 6 1 6 1 1 6 1 1 1 6 
6 1 1 6 1 1 6 1 1 6 5 5 5 5 5 6 1 6 1 1 10 7 11 7 8 
6 1 1 6 1 1 6 1 1 6 5 5 5 5 5 6 1 6 1 1 6 23 6 24 6 
6 1 3 6 1 1 6 1 1 10 14 14 14 14 14 9 7 12 1 1 10 7 8 7 12 
8 7 7 8 7 7 9 11 7 18 5 5 5 5 5 2 1 6 1 1 6 3 6 26 6 
6 1 1 6 1 1 1 6 1 2 5 5 5 5 5 2 1 10 7 7 9 7 8 7 9 
6 1 1 15 17 1 1 6 1 1 5 5 5 5 5 1 1 6 1 1 1 1 6 1 1 
6 1 1 1 6 1 4 6 1 1 5 5 5 5 5 1 1 6 1 1 1 1 6 1 1 
9 7 7 7 9 11 7 9 17 2 5 5 5 5 5 16 7 9 7 7 7 11 9 7 11 
1 1 1 1 1 6 1 1 10 7 14 14 14 14 14 12 1 1 1 1 1 6 1 1 6 
1 1 1 1 1 6 1 1 6 2 5 5 5 5 5 6 3 1 1 1 1 6 1 4 6 
1 16 11 7 7 8 7 7 12 2 5 5 5 5 5 10 7 7 11 7 7 9 11 7 8 
1 15 18 1 1 6 1 1 6 2 5 5 5 5 5 6 1 1 6 1 1 1 6 1 6 
1 1 1 1 1 6 1 1 6 1 5 5 5 5 5 6 1 1 6 1 1 16 18 1 6 
7 11 7 11 7 12 1 1 6 1 5 5 5 5 5 6 1 1 6 1 16 18 1 1 6 
1 6 20 6 19 6 1 1 10 7 14 14 14 14 14 12 1 1 6 1 6 1 1 1 6 
1 10 7 8 7 12 1 1 6 1 5 5 5 5 5 15 7 11 9 7 9 11 7 7 8 
1 6 22 6 3 6 1 1 6 1 5 5 5 5 5 1 1 6 3 1 1 6 1 1 6 
11 9 7 9 7 9 7 7 12 1 5 5 5 5 5 2 1 6 1 1 1 6 1 1 6 
6 1 1 1 1 1 1 1 6 1 5 5 5 5 5 2 1 10 7 7 7 9 7 7 8 
6 1 1 1 1 1 1 1 6 1 5 5 5 5 5 2 1 6 1 1 1 1 1 1 6 
10 7 7 7 7 7 7 7 12 1 5 5 5 5 5 2 1 6 1 1 1 1 1 1 6 
