20 20
5 5 5 5 5 5 5 5 5 10 7 12 1 1 1 10 7 7 7 8 
5 5 5 5 5 5 5 5 5 6 1 6 19 1 1 6 20 1 22 6 
5 5 5 5 5 5 5 5 5 6 1 10 7 7 7 12 1 1 1 6 
5 5 5 5 5 5 5 5 5 6 1 6 1 1 3 10 7 7 7 9 
5 5 5 5 5 5 5 5 5 15 7 9 7 7 7 18 21 5 5 5 
5 5 5 5 5 5 5 5 5 5 5 5 5 5 5 5 5 5 5 5 
5 5 5 5 5 5 5 5 5 5 5 5 5 5 5 5 5 5 5 5 
5 5 5 5 5 5 5 5 5 5 5 5 5 5 5 5 5 5 5 5 
5 5 5 5 5 5 5 5 5 5 5 5 5 5 5 5 5 5 5 5 
5 5 16 7 17 5 5 5 5 5 5 5 5 5 5 5 5 5 5 5 
5 16 18 3 10 7 7 17 5 5 5 5 5 5 5 5 5 5 5 5 
5 6 1 1 6 1 1 6 5 5 5 5 5 5 5 5 5 5 5 5 
5 6 1 1 6 1 1 6 5 5 5 5 5 5 5 5 5 5 5 5 
5 15 11 7 9 11 7 12 5 5 5 5 5 5 5 5 5 16 7 7 
5 5 6 1 1 6 1 6 5 5 5 5 5 5 5 5 5 6 3 1 
5 5 6 1 1 6 3 6 5 5 5 5 5 5 5 5 25 6 1 1 
5 5 15 7 7 9 7 18 5 5 5 5 16 7 7 11 7 9 7 11 
5 5 5 5 5 5 5 5 5 5 5 5 6 1 23 6 1 1 24 6 
5 5 5 5 5 5 5 5 5 5 5 5 6 1 1 6 1 1 26 6 
5 5 5 5 5 5 5 5 5 5 5 5 10 7 7 8 7 7 7 8 
