20 20
1 6 1 1 1 1 1 10 7 7 12 5 5 5 5 10 7 7 7 11 
1 6 1 1 1 1 1 6 1 1 6 5 5 5 5 6 1 1 3 6 
1 6 1 1 1 1 3 6 1 1 6 5 5 5 5 6 1 1 1 6 
23 10 7 7 11 7 7 8 7 7 8 14 14 14 14 12 1 1 1 6 
7 12 1 1 6 1 1 6 1 1 6 5 5 5 5 10 7 7 11 9 
1 6 1 1 6 1 1 6 1 1 6 5 5 5 5 6 1 1 6 19 
1 6 1 1 6 1 1 6 1 1 6 5 5 5 5 6 1 1 6 1 
1 10 7 7 12 1 1 6 1 1 6 5 5 5 5 6 1 1 6 1 
1 6 1 1 10 7 7 12 1 1 6 14 14 14 14 12 1 22 6 1 
1 6 26 1 6 1 1 6 1 1 6 5 5 5 5 15 11 7 9 11 
7 8 7 7 12 1 1 10 7 7 9 17 5 5 5 5 6 1 1 6 
1 6 1 1 6 1 1 6 1 1 1 6 5 5 5 5 6 1 1 6 
1 6 1 1 6 1 1 6 1 1 1 6 5 5 5 5 6 1 1 6 
1 6 1 1 10 7 7 12 1 1 1 6 5 5 5 5 15 11 7 9 
1 6 1 1 6 1 1 6 1 1 1 6 1 5 5 5 5 6 1 1 
24 6 3 1 6 1 1 10 7 7 7 9 11 14 14 14 14 12 1 20 
7 9 7 11 9 7 7 12 1 1 1 1 6 5 5 5 5 15 7 7 
1 1 1 6 1 1 1 6 1 1 1 1 6 5 5 5 5 5 5 5 
1 1 1 6 1 1 1 10 7 7 7 7 12 3 5 5 5 5 5 5 
1 1 1 10 7 7 7 12 1 1 1 1 6 1 5 5 5 5 5 5 
